#####   
#O  ##  
#    ## 
##    ##
 ##  X #
  ##  P#
   #####