    #####
    #   #
    # # #
#####O P#
#  X O ##
# #X#O # 
#  X  ## 
##   ##  
 #####   