######  
#    #  
# XX ###
### P  #
  #  O #
  ## O##
   #### 