    ####
  ###  #
  # XX #
 ## #  #
## O#XP#
#      #
# OO####
#####   