 ####  
 #  ###
 # XX #
##OOO #
#  PX #
#   ###
#####  