######
#O#  #
#PXX #
#OOX #
##   #
 #####