####  
#  ###
# XX #
#OOO #
# PX #
#   ##
##### 