##########
#        #
# ##O### #
# # XX O #
# O PX## #
#####    #
    ######