     #####  
######   #  
#   ## # #  
# XPX    #  
### ### ### 
#         ##
#   ### OO #
#####    # #
    # #  # #
    #  ##  #
    ##    ##
     ###### 