#########
#       #
# # ### #
# #OOO# #
# X P X #
# ##X## #
#       #
#########