# #####
  #   #
###XXP#
#   ###
#     #
# O O #
#######