######
#OOO #
#  X #
# #X##
#  X #
#  P #
######