########
#   #  #
# P    #
## ###O#
 # X   #
 #   ###
 #####  