     #####
   ###   #
####OOOOO#
# PXXXXX #
#     # ##
#####   # 
    ##### 