#####   
#   ##  
# #  #  
# #XO###
#  OX  #
# #XO# #
# #OX# #
#  XO P#
###OX# #
  #  # #
  ##   #
   #####