#############################################################################
# ############### ######################### ######     ######################
# #############     ###   ###########   ### ### #### ####    ###########   ##
# ############### ####  #  #########  ##### #  ##### ####  #  ############# #
# ############### #### ### #########     ##   ###### #### ### #########     #
# ############### #### ### ############  ## # ###### #### ### ######### OXP #
#      ##########   ##     #########     ## ##  ##     ##     #########     #
######################################################### ###################
######################################################### ###################
#############################################################################
########   #########################   ######################################
########## #####   ### ### ###   ##### ######################################
########## ####  ## ##  #  ##  ## #### ######################################
########## ####     ###   ###     #### ######################################
########## ####   ###### ####   ###### ######################################
##########   ##     #### ####     ####   ####################################
#############################################################################