######## 
#      # 
# XO#OO##
##XOXXP #
# XO#   #
#   #####
#####    