####    
#  #### 
#OOO  # 
#O##  ##
#  X X #
###X X #
  #P   #
  ######