##### 
#O  ##
#PXX #
##   #
 ##  #
  ##O#
   ###