   ####
####  #
#  #  #
# O O #
# PXX #
# # ###
#   #  
#####  