 #####  
 #   ###
## #O  #
#  OO# #
# #  X #
#  X#X##
###P  # 
  ##### 