#####  
#   #  
# P #  
# XX###
##O O #
 #    #
 ######