       #### 
  ###### O# 
###       # 
#  XX # OO# 
# X  #  O## 
#  XX# #O###
###  #     #
  #    # # #
  ##### P  #
      #   ##
      ##### 