     #####
  ####   #
  #OOO P #
#### ## ##
#    ##  #
# ##X    #
# # X #  #
# # #X####
#     #   
#######   