 ####    
 #  #####
 #X   X #
 # O#O  #
## ### ##
# XO#O # 
# P   X# 
#####  # 
    #### 